                                                                                
                                                                                
                                                                                
                                                     ##                           
                                                                                
                                                                                
                                                                                
                                                                                ##
                             ###                                                   
          #               #                                                      
          #                                                                     
          #                                                                     
    P     #                                                                     
 ###################                                                            
                                                                                
                   #####          ##########                                    
                        #####                                                   
                             #####               ############                   
                                  #####                                         
                                       #####                                    
                                            #####                               
                                                 #####      ##########          
                                                      #####                     
                                                           #####                
             ###############                                    #####           
             #                        ##                               #####      
             #                                                            ##### 
             #                                   ###                               
             #                                                                  
             #                                                ##                       ######
             #                                                                  
             #                                                                  
             #                                                           #####       
             #                                                                  
             #                                                                  
             ###################################################################
